111111111111111
1P00001000C0001
1000110C0000001
10C00000000C001
10011C0000X0001
1100C0000000001
1000000111000C1
100000C00011001
1000C0000001001
1001110C0000001
100C00001111001
1011100C0000001
10000C000000001
1000C00111000E1
111111111111111